1111111
101P101
1E000C1
1110111
1110111
1010101
10000C1
1110111
1010101
10000C1
1111111
