1111111111111111111111111
10000C0000001000000000001
100111011110101111C111101
1001010100101010010100101
1001110111101011110111101
100000000000C0000000000P1
1001110100111110010111001
10C0000100001000010000001
1111110111001001110111111
100001010000C00001C100001
1111110101110111010111111
1C0000000100E001000000001
1111110101111111010111111
10000101C0000000010100001
1111110101111111010111111
1000000000001000000000C01
1001110111001001110111001
10C00100000000C0000100001
1110010101111111010100111
1000000100001000010000001
1001111111001001111111001
1000C0000000C000000000001
1111111111111111111111111
