1111111111111111111111111
1P000000000000000000000C1
10000000000000000000000C1
10000000000000000000000C1
10000000000000000000000C1
10000000000000000000000C1
10000000000000000000000C1
10000000000000000000000C1
10000000000000000000000C1
10000000000000000000000C1
10000000000000000000000C1
10000000000000000000000C1
10000000000000000000000C1
10000000000000000000000C1
10000000000000000000000C1
10000000000000000000000C1
10000000000000000000000C1
10000000000000000000000C1
10000000000000000000000C1
10000000000000000000000C1
10000000000000000000000C1
1E000000000000000000000C1
1111111111111111111111111
