11111111111111111111111111111
100000000000000000000000000P1
11111111111110000000001111111
10000000000000000000000000001
11111111110001111111111111111
1E000000000000000000000000001
11011100000000011110011110011
1C000000000000000000000000001
11111111111111110011111111111
11111111111110000000001111111
10000000000000000000000000001
11111111000001111111111111111
11111111111100000000001111111
11111111111100000000001111111
11111111111111111111111111111
