1111111111111111111111111
10000C0000001000000000001
1011101111101011111C11101
1010101000101010001010101
1011101111101011111011101
100000000000C0000000000P1
1011110101111111010111101
10C0000100001000010000001
1111110111101011110111111
100001010000C00001C100001
1111110101110111010111111
1C0000000100E001000000001
1111110101111111010111111
10000101C0000000010100001
1111110101111111010111111
1000000000001000000000C01
1011110111101011110111101
10C00100000000C0000100001
1111010101111111010101111
1000000100001000010000001
1011111111101011111111101
1000C0000000C000000000001
1111111111111111111111111
