1111111111111111111111111
1001110111101011110111001
1001010100101010010101001
1001110111101011110111001
1000000000000000000000001
1001110100111110010111001
1000000100001000010000001
1111110111001001110111111
1000010100000000010100001
1111110101110111010111111
1000000001000001000000001
1111110101111111010111111
1000010100000000010100001
1111110101111111010111111
1000000000001000000000001
1001110111001001110111001
1000010000000000000100001
1110010101111111010100111
1000000100001000010000001
1001111111001001111111001
1000000000000000000000001
1111111111111111111111111
