111111111111
100000000001
1E0000000001
100001100001
1000011000P1
100000000001
100000000C01
111111111111
