1111111111
1000000001
1010011001
1P00011001
1E0000C001
1111111111
