111111111
1E000P001
100000001
111111111
1000000C1
111111111
