111111111111
1E1000000001
100000000001
100000000111
1000000000P1
100000000001
100000000C01
111111111111
