11111
11P11
10C01
11E11
11111
